6
11 40 12 50 46 -1
11 57 9 50 46 -1
11 62 9 50 46 1
11 65 3 50 46 -1
11 76 9 50 46 -1
11 100 9 50 46 1